EA ./test_abc_dir/xpm_files/wall-design.xpm
SO ./test_abc_dir/xpm_files/wall-design.xpm
NO ./test_abc_dir/xpm_files/wall-design.xpm
WE ./test_abc_dir/xpm_files/wall-design.xpm

F 255,255,255
C 255,255,255

1
 1
  1
   1
    1
     1
      1
       1
        1
         1
         11111111111111111111111111111111111111111111111111111111
         100000000S                                             1
         100001100                                             11
         11111111111111111111111111111111111111111111111111111111
1
 1
  1
   1
    1
     1
      1
       1
        1
         1
1
 1
  1
   1
    1
     1
      1
       1
        1
         1
1
 1
  1
   1
    1
     1
      1
       1
        1
         1
1
 1
  1
   1
    1
     1
      1
       1
        1
         1
1
 1
  1
   1
    1
     1
      1
       1
        1
         1
1
 1
  1
   1
    1
     1
      1
       1
        1
         1
1
 1
  1
   1
    1
     1
      1
       1
        1
         11111111111
         10000000001
         10000110011
         11111111111
1
 1
  1
   1
    1
     1
      1
       1
        1
         1
1
 1
  1
   1
    1
     1
      1
       1
        1
         1
1
 1
  1
   1
    1
     1
      1
       1
        1
         1
1
 1
  1
   1
    1
     1
      1
       1
        1
         1
1
 1
  1
   1
    1
     1
      1
       1
        1
         1
1
 1
  1
   1
    1
     1
      1
       1
        1
         1
1
 1
  1
   1
    1
     1
      1
       1
        1
         1
1
 1
  1
   1
    1
     1
      1
       1
        1
         1
1
 1
  1
   1
    1
     1
      1
       1
        1
         1
1
 1
  1
   1
    1
     1
      1
       1
        1
         1
1
 1
  1
   1
    1
     1
      1
       1
        1
         1
1
 1
  1
   1
    1
     1
      1
       1
        1
         1
1
 1
  1
   1
    1
     1
      1
       1
        1
         1
1
 1
  1
   1
    1
     1
      1
       1
        1
         1
1
 1
  1
   1
    1
     1
      1
       1
        1
         1
1
 1
  1
   1
    1
     1
      1
       1
        1
         1
1
 1
  1
