EA ./test_abc_dir/xpm_files/wall-design.xpm
SO ./test_abc_dir/xpm_files/wall-design.xpm
NO ./test_abc_dir/xpm_files/wall-design.xpm
WE ./test_abc_dir/xpm_files/wall-design.xpm

F 255,255,255
C 255,255,255

1111111111111111111111111111111111111111111111111111111111111111
 11111111111111111111111111111111111111111111111111111111111111 
  111111111111111111111111111111111111111111111111111111111111  
   1111111111111111111111111111111111111111111111111111111111   
    1111111111111111111111111111111111111111111111111111111     
     11111111111111111111111111111111111111111111111111111      
      111111111111111111111111111111111111111111111111111       
       1111111111111111111111111111111111111111111111111        
        111111111111111111111111111111111111111111111111        
         1111111111111111111111111111111111111111111111         
          11111111111111111111101111111111111111111111          
           111111111111111111111111111111111111111111           
            1111111111111111111111111111111111111111            
             11111111111111111111111111111111111111             
              111111111111111111111111111111111111              
               1111111111111111111111111111111111               
                11111111111111111111111111111111                
                 111111111111111111111111111111                 
                  1111111111111111111111111111                  
                   11111111111111111111111111                   
                    111111111111111111111111                    
                     1111111111111111111111                     
                      11111111111111111111                      
                       111111111111111111                       
                        1111111111111111                        
                         11111111111111                         
                          111111111111                          
                           1111111111                           
                            11111111
                             111111
                              11111
                               111 
                                1  
1111111111111111111111111111111111111111111111111111111111111111
 11111111111111111111111111111111111111111111111111111111111111 
  111111111111111111111111111111111111111111111111111111111111  
   1111111111111111111111111111111111111111111111111111111111   
    1111111111111111111111111111111111111111111111111111111     
     11111111111111111111111111111111111111111111111111111      
      111111111111111111111111111111111111111111111111111       
       1111111111111111111111111111111111111111111111111        
        111111111111111111111111111111111111111111111111        
         1111111111111111111111111111111111111111111111         
          11111111111111111111101111111111111111111111          
           111111111111111111111111111111111111111111           
            1111111111111111111111111111111111111111            
             11111111111111111111111111111111111111             
              111111111111111111111111111111111111              
               1111111111111111111111111111111111               
                11111111111111111111111111111111                
                 111111111111111111111111111111                 
                  1111111111111111111111111111                  
                   11111111111111111111111111                   
                    111111111111111111111111                    
                     1111111111111111111111                     
                      11111111111111111111                      
                       111111111111111111                       
                        1111111111111111                        
                         11111111111111                         
                          111111111111                          
                           1111111111                           
                            11111111
                             111111
                              11111
                               111 
                                1  
1111111111111111111111111111111111111111111111111111111111111111
 11111111111111111111111111111111111111111111111111111111111111 
  111111111111111111111111111111111111111111111111111111111111  
   1111111111111111111111111111111111111111111111111111111111   
    1111111111111111111111111111111111111111111111111111111     
     11111111111111111111111111111111111111111111111111111      
      111111111111111111111111111111111111111111111111111       
       1111111111111111111111111111111111111111111111111        
        111111111111111111111111111111111111111111111111        
         1111111111111111111111111111111111111111111111         
          11111111111111111111101111111111111111111111          
           111111111111111111111111111111111111111111           
            1111111111111111111111111111111111111111            
             11111111111111111111111111111111111111             
              111111111111111111111111111111111111              
               1111111111111111111111111111111111               
                11111111111111111111111111111111                
                 111111111111111111111111111111                 
                  1111111111111111111111111111                  
                   11111111111111111111111111                   
                    111111111111111111111111                    
                     1111111111111111111111                     
                      11111111111111111111                      
                       111111111111111111                       
                        1111111111111111                        
                         11111111111111                         
                          111111111111                          
                           1111111111                           
                            11111111
                             111111
                              11111
                               111 
                                1  
1111111111111111111111111111111111111111111111111111111111111111
 11111111111111111111111111111111111111111111111111111111111111 
  111111111111111111111111111111111111111111111111111111111111  
   1111111111111111111111111111111111111111111111111111111111   
    1111111111111111111111111111111111111111111111111111111     
     11111111111111111111111111111111111111111111111111111      
      111111111111111111111111111111111111111111111111111       
       1111111111111111111111111111111111111111111111111        
        111111111111111111111111111111111111111111111111        
         1111111111111111111111111111111111111111111111         
          11111111111111111111101111111111111111111111          
           111111111111111111111111111111111111111111           
            1111111111111111111111111111111111111111            
             11111111111111111111111111111111111111             
              111111111111111111111111111111111111              
               1111111111111111111111111111111111               
                11111111111111111111111111111111                
                 111111111111111111111111111111                 
                  1111111111111111111111111111                  
                   11111111111111111111111111                   
                    111111111111111111111111                    
                     1111111111111111111111                     
                      11111111111111111111                      
                       111111111111111111                       
                        1111111111111111                        
                         11111111111111                         
                          111111111111                          
                           1111111111                           
                            11111111
                             111111
                              11111
                               111 
                                1  
1111111111111111111111111111111111111111111111111111111111111111
 11111111111111111111111111111111111111111111111111111111111111 
  111111111111111111111111111111111111111111111111111111111111  
   1111111111111111111111111111111111111111111111111111111111   
    1111111111111111111111111111111111111111111111111111111     
     11111111111111111111111111111111111111111111111111111      
      111111111111111111111111111111111111111111111111111       
       1111111111111111111111111111111111111111111111111        
        111111111111111111111111111111111111111111111111        
         1111111111111111111111111111111111111111111111         
          11111111111111111111101111111111111111111111          
           111111111111111111111111111111111111111111           
            1111111111111111111111111111111111111111            
             11111111111111111111111111111111111111             
              111111111111111111111111111111111111              
               1111111111111111111111111111111111               
                11111111111111111111111111111111                
                 111111111111111111111111111111                 
                  1111111111111111111111111111                  
                   11111111111111111111111111                   
                    111111111111111111111111                    
                     1111111111111111111111                     
                      11111111111111111111                      
                       111111111111111111                       
                        1111111111111111                        
                         11111111111111                         
                          111111111111                          
                           1111111111                           
                            11111111
                             111111
                              11111
                               111 
                                1  
1111111111111111111111111111111111111111111111111111111111111111
 11111111111111111111111111111111111111111111111111111111111111 
  111111111111111111111111111111111111111111111111111111111111  
   1111111111111111111111111111111111111111111111111111111111   
    1111111111111111111111111111111111111111111111111111111     
     11111111111111111111111111111111111111111111111111111      
      111111111111111111111111111111111111111111111111111       
       1111111111111111111111111111111111111111111111111        
        111111111111111111111111111111111111111111111111        
         1111111111111111111111111111111111111111111111         
          11111111111111111111101111111111111111111111          
           111111111111111111111111111111111111111111           
            1111111111111111111111111111111111111111            
             11111111111111111111111111111111111111             
              111111111111111111111111111111111111              
               1111111111111111111111111111111111               
                11111111111111111111111111111111                
                 111111111111111111111111111111                 
                  1111111111111111111111111111                  
                   11111111111111111111111111                   
                    111111111111111111111111                    
                     1111111111111111111111                     
                      11111111111111111111                      
                       111111111111111111                       
                        1111111111111111                        
                         11111111111111                         
                          111111111111                          
                           1111111111                           
                            11111111
                             111111
                              11111
                               111 
                                1  
1111111111111111111111111111111111111111111111111111111111111111
 11111111111111111111111111111111111111111111111111111111111111 
  111111111111111111111111111111111111111111111111111111111111  
   1111111111111111111111111111111111111111111111111111111111   
    1111111111111111111111111111111111111111111111111111111     
     11111111111111111111111111111111111111111111111111111      
      111111111111111111111111111111111111111111111111111       
       1111111111111111111111111111111111111111111111111        
        111111111111111111111111111111111111111111111111        
         1111111111111111111111011111111111111111111111         
          111111111111111111110S0111111111111111111111          
           111111111111111111110111111111111111111111           
            1111111111111111111111111111111111111111            
             11111111111111111111111111111111111111             
              111111111111111111111111111111111111              
               1111111111111111111111111111111111               
                11111111111111111111111111111111                
                 111111111111111111111111111111                 
                  1111111111111111111111111111                  
                   11111111111111111111111111                   
                    111111111111111111111111                    
                     1111111111111111111111                     
                      11111111111111111111                      
                       111111111111111111                       
                        1111111111111111                        
                         11111111111111                         
                          111111111111                          
                           1111111111                           
                            11111111
                             111111
                              11111
                               111 
                                1  
