EA                         ./test_abc_dir/xpm_files/wall-design.xpm                                  
SO ./test_abc_dir/xpm_files/wall-design.xpm
NO ./test_abc_dir/xpm_files/wall-design.xpm
WE ./test_abc_dir/xpm_files/wall-design.xpm

C 0,0,0                                                                 

F 255,255,255

1111                                                    1111
1001                                                    1001
1111                                                    1111
                  11111              1111111
                  10001              1000001
                  10001              1000001
                  11111              1111111
111      11                   111                         1111111
111111           1                   1              1
1111111        111111111111111111111111111111                     1111
               110000000000000000000000000111                     1001
               100000000000000000000000000001                     111
               100000000000000000000000000001
               100000000000000000000000000S01
               100000000000000000000000000001
               100000000000000000000000000001
               100000000000000000000000000001
               100000000000000000000000000001
               100000000000000000000000000001
               100000000000000000000000000001
               111111111111111111111111111111                                              1
11111111111111111                                       1111111111111            11111
1                    1                       1                              1     
1111                     1                        1                      1          1    
11101
11001
10001
11111                   1111111111           11            1                      11     1
11111111
11111111
11111111
11111111
11111111
11111111
11111111
11111111
11111111
11111111
11111111
11111111
11111111
11111111
11111111
1111111                              1      111   1 1 1  1  1 1    11   1 1 1 1 1 1 1 1 1  1
1                 1          11 111                             11                    111 1 
1 1 1 11 1 11 1  1 1 1 1 1 1
111111111111111111111111111111111111111111111111111111111111111111111111111111111111111
111110000000000000000000000000000000000000000000000000000000000000000000000000000000001
11111                                                                                 1
111111111111111111111111111111111111111111111111111111111111111111111111111111111111111
1
