EA ./test_abc_dir/xpm_files/wall-design.xpm
SO ./test_abc_dir/xpm_files/wall-design.xpm
NO ./test_abc_dir/xpm_files/wall-design.xpm
WE ./test_abc_dir/xpm_files/wall-design.xpm

F 255,255,255
C 255,255,255


1
11
101
1001
10001
100001
1000001
10000001
100000001
1000000001
10000000001
100000000001
1000000000001
10000000000001
100000000000001
1000000000000001
10000000000000001
100000000000000001
1000000000000000001
10000000000000000001
100000000000000000001
1000000000000000000001
10000000000000000000001
100000000000000000000001
1000000000000000000000001
10000000000000000000000001
100000000000000000000000001
1000000000000000000000000001
10000000000000000000000000001
100000000000000000000000000001
1000000000000000000000000000001
10000000000000000000000000000001
100000000000000000000000000000001
1000000000000000000000000000000001
10000000000000000000000000000000001
100000000000000000000000000000000001
1000000000000000000000000000000000001
10000000000000000000000000000000000001
100000000000000000000000000000000000001
1000000000000000000000000000000000000001
10000000000000000000000000000000000000001                                                                                 111111111111111
100000000000000000000000000000000000000001                                                                                100001000001101
100000000000000000000000000000000000000001                                                                                100001000001101
100000000000000000000000000000000000000001                                                                                100001000001101
100000000000000000000000000000000000000001                                                                                100001000000001
10N0000000000000000000000000000000000000001                                                                               111111111111111
10000000000000000000000000000000000000000001
100000000000000000000000000000000000000000001
1000000000000000000000000000000000000000000001
10000000000000000000000000000000000000000000001
100000000000000000000000000000000000000000000001
1000000000000000000000000000000000000000000000001
10000000000000000000000000000000000000000000000001
100000000000000000000000000000000000000000000000001
1000000000000000000000000000000000000000000000000001
10000000000000000000000000000000000000000000000000001
100000000000000000000000000000000000000000000000000001
1000000000000000000000000000000000000000000000000000001
10000000000000000000000000000000000000000000000000000001
100000000000000000000000000000000000000000000000000000001
1000000000000000000000000000000000000000000000000000000001
10000000000000000000000000000000000000000000000000000000001
100000000000000000000000000000000000000000000000000000000001
1000000000000000000000000000000000000000000000000000000000001
10000000000000000000000000000000000000000000000000000000000001
100000000000000000000000000000000000000000000000000000000000001
1000000000000000000000000000000000000000000000000000000000000001
10000000000000000000000000000000000000000000000000000000000000001
100000000000000000000000000000000000000000000000000000000000000001
1000000000000000000000000000000000000000000000000000000000000000001
10000000000000000000000000000000000000000000000000000000000000000001
100000000000000000000000000000000000000000000000000000000000000000001
1000000000000000000000000000000000000000000000000000000000000000000001
10000000000000000000000000000000000000000000000000000000000000000000001
100000000000000000000000000000000000000000000000000000000000000000000001
1000000000000000000000000000000000000000000000000000000000000000000000001
10000000000000000000000000000000000000000000000000000000000000000000000001
100000000000000000000000000000000000000000000000000000000000000000000000001
1000000000000000000000000000000000000000000000000000000000000000000000000001
10000000000000000000000000000000000000000000000000000000000000000000000000001
100000000000000000000000000000000000000000000000000000000000000000000000000001
1000000000000000000000000000000000000000000000000000000000000000000000000000001
10000000000000000000000000000000000000000000000000000000000000000000000000000001
100000000000000000000000000000000000000000000000000000000000000000000000000000001
1000000000000000000000000000000000000000000000000000000000000000000000000000000001
10000000000000000000000000000000000000000000000000000000000000000000000000000000001
100000000000000000000000000000000000000000000000000000000000000000000000000000000001
1000000000000000000000000000000000000000000000000000000000000000000000000000000000001
10000000000000000000000000000000000000000000000000000000000000000000000000000000000001
10000000000000000000000000000000000000000000000000000000000000000000000000000000000001
10001111111111111111111111111111111111111111111111111111111111111111111111111111111111
10001
10001
1111
