EA ./test_abc_dir/xpm_files/dirt_block.xpm
SO ./test_abc_dir/xpm_files/dirt_block.xpm
NO ./test_abc_dir/xpm_files/dirt_block.xpm
WE ./test_abc_dir/xpm_files/dirt_block.xpm

F 211,211,0
C 211,0,211


111111             111111111111111111             1111111111111111111111111111111111111 11111 111111
111111             111111111111111111             1111111111111111111111111111111111111 11111 111111
111111             111111111111111111             1111111111111111111111111111111111111 11111 111111
            111111111111111111111111111111111111111111111111111111111111111                  1111111
111111      111111111111111111111111111111111111111111111111111      111111111111      1111111111111
111111      111111111111111111111111111111111111111111111111111      111111111111      1111111111111
111111      111111111111111111111111111111111111111111111111111      111111111111      1111111111111
111111 111111111111111111111111             1111111111111111111111111111111111111      1111111111111
111111 111111111111111111111111             1111111111111111111111111111111111111      1111111111111
111111 111111111111111111111111             1111111111111111111111111111111111111      1111111111111
      111111 11111 111111111111       11111 111111            1111111111111111111111111       111111
      111111 111111111111111111       11111 111111             111111111111111111111111       111111
      111111 111111111111111111       11111 111111             111111111111111111111111       111111
      111111 111111     1111111       11111 111111            1111111111111111111111111       111111
      1111111      111111111111       111111111111      111111111111 111111111111      1111111111111
      1111111      111111111111       111111111111      111111111111 111111111111      1111111111111
      1111111      111111111111  00000111111111111      111111111111 111111111111      1111111111111
1111110000000  0000000   000000      00000000000000000000000000000000000000000000000000000000 000001
1000000000000    00000   000000      00000000000000000000000000000000000000000000000000000000 000001
1000000000000       N    000000      00000000000000000000000000000000000000000000000000000000 000001
1000000000000            000000      00000000000000000000000000      0000000000001111111111111111111
111111 111111111111111111111111111111111111 111111111111 11111 111111111111111111       111111      
111111 111111111111111111111111111111111111 111111111111 11111 111111111111111111       111111      
111111 111111111111111111111111111111111111 111111111111 11111 111111111111111111       111111      
111111111111 111111111111            1111111111111      1111111      111111111111                   
111111111111 111111111111            1111111111111      1111111      111111111111                   
111111111111 111111111111            1111111111111      1111111      111111111111                   
      111111     000000000000000000001111111111111      1111111      111111            1111111      
      1111111111111      111111      1111111111111111111       111111111111            1111111111111
      1111111111111      111111      1111111111111111111       111111111111            1111111111111
      1111111111111      111111      1111111111111111111       111111111111            1111111111111
111111      11111111111111111111111111111111111111111111       111111111111111111111111 111111      
111111      11111111111111111111111111111111111111111111       111111111111111111111111 111111      
111111      11111111111111111111111111111111111111111111       111111111111111111111111 111111      
111111      1111111      111111111111             111111 111111      111111                   111111
111111       11111 111111111111      1111111      111111111111111111 111111                   111111
111111       11111 111111111111      1111111      111111111111111111 111111                   111111
111111       11111 111111111111      1111111      111111111111111111 111111                   111111
      1111111111111      111111       111111      111111      1111111111111             111111111111
      1111111111111      111111       111111      111111      1111111111111             111111111111
      1111111111111      111111       111111      111111      1111111111111             111111111111
1111111111111111111      111111111111 11111 111111      1111111111111      111111111111 111111      
1111111111111111111      111111111111 1111111111111111111111111111111      111111111111 111111111111
1111111111111111111      111111111111 1111111111111111111111111111111      111111111111 111111111111
1111111111111111111      111111111111 11111 1111111111111111111111111      111111111111 111111111111
111111       111111111111111111111111             1111111111111111111111111111111111111             
111111       111111111111111111111111             1111111111111111111111111111111111111             
111111       111111111111111111111111             1111111111111111111111111111111111111             
      111111111111 1111111111111111111111111111111111111 111111111111      111111111111             
      111111111111 1111111111111111111111111111111111111 111111111111      111111111111             
      111111111111 1111111111111111111111111111111111111 111111111111      111111111111             
      111111       11111  111111111111     1111111111111 111111111111            111111       111111
      111111 111111            111111       111111             111111111111             111111111111
      111111 111111            111111       111111             111111111111             111111111111
      111111 111111            111111       111111             111111111111             111111111111
