EA ./test_abc_dir/xpm_files/grey_wall.xpm
SO ./test_abc_dir/xpm_files/grey_wall.xpm
NO ./test_abc_dir/xpm_files/grey_wall.xpm
WE ./test_abc_dir/xpm_files/grey_wall.xpm

F 122,255,0
C 211,0,211

                                                       1
11111111111111111                                      1 
1         111111111111111111                  11111111111111111
1                1111111111111111111                   1
1                          11111111111111111           1
1                                 111111111111111111
1                                          1111111111111111111
1           111111111111                           111111111111111111111
1                 E                                     111111111111111111111
1           111111111111                           111111111111111111111
1                                          1111111111111111111
1                                 111111111111111111
1                          11111111111111111            1
1                1111111111111111111                    1
1         111111111111111111                    111111111111111111
11111111111111111                                       1
                                                        1
