EA ./test_abc_dir/xpm_files/4th_brick_wall.xpm
SO ./test_abc_dir/xpm_files/4th_brick_wall.xpm
NO ./test_abc_dir/xpm_files/4th_brick_wall.xpm
WE ./test_abc_dir/xpm_files/4th_brick_wall.xpm

F 255,255,0
C 255,0,255


                         1              1                  
                         1              1                  
                         1              1                  
             1           1              1           1       
             1           1              1           1       
             1111111111111              1111111111111      
                  1          11111111         1
                  1         1000000001        1
                  1         1000000001         1
                  1         1000000001        1
                  1         10000S0001        1
                  1         1000000001        1
                  1         1000000001        1
                  1         1000000001        1
                  1          11111111         1
             1111111111111              1111111111111      
             1           1              1           1
             1           1              1           1
             1           1              1           1
                         1              1                 
                         1              1                 
                         1              1                 
                         1              1                 
                         1              1                 
