EA ./test_abc_dir/xpm_files/dirt_block.xpm
SO ./test_abc_dir/xpm_files/dirt_block.xpm
NO ./test_abc_dir/xpm_files/dirt_block.xpm
WE ./test_abc_dir/xpm_files/dirt_block.xpm

F 122,255,122
C 122,122,255

111111111111111111111111111111111   11111111 1  11111111111 1 1111 111 111111 111111111             
1111111111111111111111111111111  1111111111111  111111  11 1111 11111111111111111111111111   11     
1111111111111  11111111  11111 1 111111111111  11111111111111111  11111 111111111111111  1 1 1 11   
1111111111111111111111111 111   1111111111111 1111111111111111111  1111111111111111111  11 1 1111111
111111111111111111111111111111 11111111111111111111111111111 1111111 1 111 111111111  111111111 11 1
1111 11111111111111111111111111 11111111111111111111111111 111111111 11        1111 11  111111  1111
111100000000000000000000001111  11111111111111111111111111111111111111111111111     11111 111111 111
111111111111111111111111111111 1111111111111111111111111111111111111111111 11111111111 1111111111111
1111111111111111 1111111111111 11111111111 1111111111111111111111111111 1111111111111 1  11111111111
11111111111111    1111  1111  1111111111111111111  1111111111111111 11 111111111111111   11111111111
111111111111111111111111 11  1111111111111111111111 1111111111111111111 111111 111111  1 11 1 11111 
1111111111111111111111111 1 1 1111111111111111111111111111111111111111111111111111111  1 11  111    
1111111111111 111111111111011 111111111111111111111111  11111111111111111111111111111 11111111111   
111111111111111111111 110000111 1111111111111111111111111111111111111111  1111111111    111111      
1111111111111111111 11111000011111111111111111 11111111 11 111111111 1 1  1111111        1111   11  
111111111111111111111111101000111111111111111111 111111111111 1111111111111 111111      11111  11   
1111111111111111111111111100000111111111111111111 11 111 111 1111111111111111111      1111111       
111   1  11111111  111 111001100111111111111111   11111111111111111 1111111111         1111111   111
111111111   11 1111111111110110001111111111111111111111111111   11 11111111 111          11111111111
 111111111111 1111111111110011100111111111111111 11111111 11   1  1111111 1          111111111111111
1111111111 111111111111111011111111111111 11111 1   11 1 1  1 11   11111111     1  1 111111111111111
111111111 1111111111111110001111111111111111  111 1111  1 11       11  1     11 11 11111111111111111
1 111     111111111  1111000111111111111  111111111   1   1        111 11     11 1111111   1111111 1
1111111  111  111111111000011 11111111 11  1  11 111  1                1   1 1    1      1111111111 
111 1 1111111111111111100001 11111111111 11      1 1 11      1           1     1 11 1   11 111111111
1111 111111111111111111110111111111111    111  1  11  1       1          1    111  111 11111111111  
1111      11011111111111101 1111111111            11                     11   1 11   111111111111   
1          11111101111110011111111111111    1 111 111    1                1   1111 1   1 1111111    
          111111111111111111 1111111    1    11                              1111 1   111 11  11    
         1111111111011111111111111  1   1   1                                 11   1  111 11111    1
        11111111111011111111111111111                                              1111111  111    1
       111111111N0001110100110011111 11  11                                        111 111 11 11    1
    111 11111111111111 111111111 111111                                           1       11111   11
     1111100000000000010001111111111111 1   1 1 11                                          1     11
1  111111111111111110111111111111111111   1      1                          1                  11111
111111111111111011111111111111111111    1       1                                        1     11111
1111111111111001111111111111111  1  1     1                                           1       1111  
11 11111110111111111111111111  11111 11                                                  1        11
11111111110111111111111111111111 111 11    1                                                    1111
1111 111111111 111   1 11111111   1 1111                                                   1 11  111
11111111111111111111111111111 111 1 1   1                                                   1 111111
11111111111111111 1111111 111111  11111   1  1                                                 1111 
1111111111111111 11111111111111 111 1      1  1                                                11111
1111111111111    11 111111 11 111111    111111            11                                  111 11
11111111111     1111 11 11 1111  1   1111111111   111  1                                      111111
111111111111  1111111 1 11 111111         111 11 11 11   1                                   1111111
1111111111111 11111111 11 1 1111111        1 11111111 11  1    1                               11111
11111 1 1111111111 11      111 1   1          11111111 111 1  11    1                          111 1
111111111111111111       1 11111        11 1    11  11 11                                     111111
111111 111111 11      1 111 1 11      1  111111    11  1111                                     1111
111111111111111111  11111    1        111  1       111   1                                      1 11
111111  111111  11   1 11  1 1111      1  1    1             1                                      
1111111111111 111 1  1111   1 1             1  1                                                    
11111111111111    1   111   11    111   1       1    1  1   1 1                                     
1111111111111 11  1  1  11 11       11          11           11     1       1 1                     
