EA ./test_abc_dir/xpm_files/3rd_brick_wall.xpm
SO ./test_abc_dir/xpm_files/3rd_brick_wall.xpm
NO ./test_abc_dir/xpm_files/3rd_brick_wall.xpm
WE ./test_abc_dir/xpm_files/3rd_brick_wall.xpm

F 122,255,0
C 122,0,255

1111111111111111111111             1111111111111111             1111111111111111111
1                    111111111111111              111111111111111                 11111111111111111111111111111111111111111
1                    0             0              0             0                 0               0                       1
1                    111111111111111              111111111111111       111111111111111111111111111                       1
11111111      11111111             1     1111111111             1       1                         1            N          1
       1      1                    1     1                      1       1                         1                       1
       1      1                    1     1111111111             1       1                         11111111111      11111111
       1      1                    1     1                      1       11111111111                         1      1
       1      1                    1     1                      1                 1                         1      1
       1      1                    1     1111111111             1                 1                         1      1
       1      1                    1              1             111111111111      1                         1      1
       11111111                    1111111111111111                        1      1                         1      1
                                                                           1      1                         1      1
                                                                           1      1                         1      1
                                                                111111111111      1                         111111111
                                                                1                 1
                                                                1                 1
                                                                1111111111111111111
