EA ./test_abc_dir/xpm_files/small_cursor.xpm
SO ./test_abc_dir/xpm_files/small_cursor.xpm
NO ./test_abc_dir/xpm_files/small_cursor.xpm
WE ./test_abc_dir/xpm_files/small_cursor.xpm

F 255,255,255
C 255,255,255

                                 111111111111
                                 11        11                                                       
                                 11        11                                                       
                                 11        11                                                       
                                 11        11                                                       
                                 11        11                                                       
                                 11        11                                                       
                                 11        11                                                       
                                 11        11                                                       
                                 11        11                                                       
                                 11        11                                                       
                                 11        11   11111111                                            
                                 11        11  11      11                                           
                                 11        11  11      11   1111111111                              
                                 11        11  11      11  11        11                             
                                 11        11  11      11  11        11    11                       
                                 11        11  11      11  11        11  110011                     
                                 11        11  11      11  11        11  11  111111                 
                                 11        11  11      11  11        11  11      11                 
             11111111111111      11        111111      111111        11  11      11                 
             11          11      11                                  11  11      11                 
             11          111111  11                                  111111      11                 
             11              11  11                                              11                 
             1111            11  11                                              11                 
          11   1111          11  11                                              11                 
         1111    1111        11  11                                              11                 
                   11        111111                                              11                 
                   11                                                            11                 
                   11                                                            11                 
                    111                                                          11                 
                      11111                                                      11                 
                         11                                                      11                 
                         11                                                  11111                  
                         111111                                              11                     
                             11                                              11                     
                             11                                              11                     
                             11                                              11                     
                             111111                                          11                     
                                 11                                         W11                     
                                 11                                      1111                        
                                 11                                      11                         
                                 11                                      11                         
                                  1111111111111111111111111111111111111111                          
                                                                                                    
                                                                                                    
                                                                                                    
                                                                                                    
                                                                                                    
                                                                                                    
                                                                                                    
