EA ./test_abc_dir/xpm_files/wall-design.xpm
SO ./test_abc_dir/xpm_files/wall-design.xpm
NO ./test_abc_dir/xpm_files/wall-design.xpm
WE ./test_abc_dir/xpm_files/wall-design.xpm

F 255,255,255
C 255,255,255

                           111111111111111111                         
                           100000000000000001                         
                           1                1                         
                           1                1                         
                           1                1
                           1                1
 111111111111111111111111111                11111111111111111111111111111111111111111
 1                                                                                  1
 1                                                                                  1
 1                                                                                  1
 1                                                                                  1
 1                                                                                  1
 1                                                                                  1
 1                                                                                  1
 1                                                                                  1
 1                                                                                  1
 1                                                                                  1
 1                                                                                  1
 1                                                                                  1
 1                                                                                  1
 1                                                                                  1
 1                                                                                  1111111111111111111111111111111111111111
 1                                                                                                                         1
 1                                                                                                                         1
 1                                                                                                                         1
 1                                                                                                                         1
 1                                                                                                                         1
1 1                                                                                                                         1
 1                                                                                                                         1
1 1                                                                                                                         1
 1                                                                                                                         1
 1                                                                                                                         1
 1                                                                                                                         1
 1                                                                                                                         1
 1                                                                                                                         1
 1                                                                                                                         1
 1                                                                                                                         1
 1                                                                                                                         1
 1                                                                                                                         1
 1                                                                                                                         1
 1                                                                                  1111111111111111111111111111111111111111
 1                                                                                  1
 1                                                                                  1
 1                                                                                  1
 1                                      S                                           1
 1                                                                                  1
 1                                                                                  1
 1                                                                                  1
 1                                                                                  1
 1                                                                                  1
 1                                                                                  1
 1                                                                                  1
 1                                                                                  1
 1                                                                                  1
 1                                                                                  1
 1                                                                                  1
 1                                                                                  1
 1                                                                                  1
 1                                                                                  1
 1                                                                                  1
 1                                                                                  1
 111111111111111111111111111111111111111111                  111111111111111111111111
                                          1                  1
                                          1                  1
                                          1                  1111111111111111111111
                                          1                                       1
                                          1                                       1
                                          1                                       111111111111111111111
                                          1                                                           1
                                          1                                                           1
                                          1                                                           1
                                          1                                                           1
                                          1                                                           1
                                          1                                                           1
                                          1                                                           1
                                          1                                                           1
                                          1                                       111111111111111111111
                                          1                                       1
                                          1                                       1
                                          1                                       1
                                          1                                       1
                                          1                                       1
                                          1                                       1
                                          1                  1111111111111111111111
                                          1                  1
                                          1                  1
                                          1                  1
                                          11111111111111111111
