EA ./test_abc_dir/xpm_files/wall-design.xpm
SO ./test_abc_dir/xpm_files/wall-design.xpm
NO ./test_abc_dir/xpm_files/wall-design.xpm
WE ./test_abc_dir/xpm_files/wall-design.xpm

F 255,255,255
C 255,255,255

1111111111111111111111111111111111111111111111111111111111111111111111111111111111111111111111111111
1111111111111111111111111111111111111111111111111111111111111111111111111111111111111111111111111111
1111111111111111111111111111111111111111111111111111111111111111111111111111111111111111111111111111
1111111111111111111111111111111111111111111111111111111111111111111111111111111111111111111111111111
111111111111111111111111111111111111111111111111111111   000  0   0 11111111111111111111111111111111
111111111111111 00     00  0        0     0 0    0        0000    00   0 0  111111111111111111111111
1111111111111 000     000000                           00000 0        0 00 0  0 11111111111111111111
111111111111  0 0000000000000000000000000000                     0000000    0 0    11111111111111111
11111111111 000 0                                                 000000 0000    0  0111111111111111
11111111111  000 0    0                       000         0000000    00000000000  0    1111111111111
111111111111      0000   00000  00000000000000    0   0000    000000000000000000000     111111111111
111111111111      00  000 0000000000000000000           0  000   00000000000000000000     1111111111
111111111111111   0   0000 000000000000000000      00 0    00 000 0000000000000000  00     111111111
111111111111111111  1   0   00000000000000000    000111  1   00 0  0000000000000000   0 0  111111111
11111111111111111111   00 0 00000000000000000    0  1111111    0000 0000000000000000   0   011111111
111111111111111111111  00   00 00000000000000    0  11111111    00 0 0000000000000000     0011111111
111111111111111111111 000   00  0000000000000    0  111111111    0 0 000 000000000000     00 1111111
111111111111111111111 0     00  0000000000000    0  1111111111   0    00 0000000000000     001111111
111111111111111111111 000   00  0000000000000    0  1111111111   0    00 0000000000000   00 01111111
111111111111111111111 0 0   00  0000000000000    0  1111111111   0       0000000000000   00 01111111
111111111111111111111 000   0   0000000000000    0  1111111111   0 0 0   0000000000000   00001111111
111111111111111111111 0 0   0   0000000000000    0  1111111111 000 0     000000000000    0   1111111
111111111111111111111 0 0   0   0000000000000 N  0  1111111111 00 000    000000000000    0  11111111
111111111111111111111 0 0   0   0000000000000    00 111111111           000000000000       011111111
111111111111111111111 0     0   0000000000000    0  11111110            00000000000     00 111111111
111111111111111111111 0 0   0   0000000000000    0        0  00000     0000000000     0    111111111
111111111111111111111 0 0   0   0000000000000   0 0 0        00        00000000      0000 1111111111
111111111111111111111   0   0   0000000000000000000000000           000000000      0  0  11111111111
1111111111111111111111 00   0   0000000000000000000              000000000       00   01111111111111
111111111111111111111 0 0   0   00000000000000000000000000000000000000          0  0 111111111111111
111111111111111111111  00   0   00000000000000                       0      0 0    11111111111111111
111111111111111111111 000   0   0000000000000    0     0  00            0      011111111111111111111
111111111111111111111 0 0   0   0000000000000   0 0                     0    11111111111111111111111
1111111111111111111111000   0   0000000000000   0   0   0   00 0    00  1111111111111111111111111111
111111111111111111111 0 0   0   000000000000       1111111111111111111111111111111111111111111111111
111111111111111111111 0 0   00  000000000000       1111111111111111111111111111111111111111111111111
111111111111111111111 00  0 0   0000000000000      1111111111111111111111111111111111111111111111111
111111111111111111111 0 0 0 0  00000000000000    0  111111111111111111111111111111111111111111111111
111111111111111111111 000 0    00000000000000    0 0111111111111111111111111111111111111111111111111
111111111111111111111  0 0 0   00000000000000    0 0111111111111111111111111111111111111111111111111
111111111111111111111  0  00   00000000000000    0  111111111111111111111111111111111111111111111111
111111111111111111111000 0 0   00000000000000   000  11111111111111111111111111111111111111111111111
111111111111111111 0   00 0    00000000000000   00 000  11111111111111111111111111111111111111111111
111111111111111000   0 00     00000000000000000 000  0  00 11111111111111111111111111111111111111111
11111111111111000   0         000000000000000000000000  0   1111111111111111111111111111111111111111
11111111111111000   00 00000000000000000000000000000   0 00 1111111111111111111111111111111111111111
1111111111111   0  00   00000000000000000000000        0  0 1111111111111111111111111111111111111111
1111111111111    00 000000                       00000  00011111111111111111111111111111111111111111
11111111111111 1 0 000000        0        0 0  0         1111111111111111111111111111111111111111111
111111111111111111   000 00  0             0 0  00  0 1111111111111111111111111111111111111111111111
111111111111111111111111111    00 0           111111111111111111111111111111111111111111111111111111
1111111111111111111111111111111111111111111111111111111111111111111111111111111111111111111111111111
1111111111111111111111111111111111111111111111111111111111111111111111111111111111111111111111111111
1111111111111111111111111111111111111111111111111111111111111111111111111111111111111111111111111111
1111111111111111111111111111111111111111111111111111111111111111111111111111111111111111111111111111
