C                    48,204, 255
            EA ./textures/x512/cut_copper_512.xpm     
       SO ./textures/x512/cut_copper_512.xpm
NO ./textures/x512/cut_copper_512.xpm
F          42,238,0

WE                      ./textures/x512/cut_copper_512.xpm

    1111111111
    1000000001
    1011100101111
    1010000000  1
    100000N001111        111111111
    1000000001           1000000001
111110001100011111111    10000000001
1    0011000        01   100000000001
111110000000011111111    1000000000001
    111111011110000011   100001001    1
    1000000000000011     100001 01     1
    1000000000000011111111    10 1111111
     111111100000000000000000000        1
    1000000000000011111111111111        1
    100000000000001            1000000001
    100000000000001            1110111111
    111110000000001111          1   1
        100000    00001         1   1        11111
    111110000000001111          1   1        10001
    111111111111111111111111    1   1        11111
    100000000000001       1111111   1
    10000000000000              1   1
    100000000000001              0001
    100000000000001111111111111111111
    100000000000001
    1111111111111111
