NO ./test_abc_dir/xpm_files/dirt_block.xpm
SO ./test_abc_dir/xpm_files/dirt_block.xpm
EA ./test_abc_dir/xpm_files/dirt_block.xpm   
WE ./test_abc_dir/xpm_files/dirt_block.xpm

C 161,161,161
F 78,60,43

1111111111
1000000001
1011100101
1010     1
1000  0001
10000S0001
1000110001
1001100001
1000000001
1111111111
