EA ./textures/x512/cut_copper_512.xpm   
SO ./textures/x512/cut_copper_512.xpm
NO ./textures/x512/cut_copper_512.xpm
WE ./textures/x512/cut_copper_512.xpm

F 32,238,0
C 48,204,255



1111111111
1000000001
1011100101
1010000001
1000000001
10000S0001
1000110001
1001100001
1000000001
1111111111

      1111111
      1000001111111
      1000000000001
     1100N  001111111
     1000000111111101111
     10000     000000001
     111111111111111111111
      
11111111
100000001
10001111
10001
10001
10001
10001
10001
10001
10001
10001011111
100N0000001
11111111111

111111111111111
100000000000001
100000000000001
100000000000001
100000000000001
100000000000001
100000000000001
100000000000001
100000000000001
1000000000000P1
111111111111111

111111111111111
100000000000001
100000000000001
100000000000001
100000000000001
100000000000001
100000000000001
100000000000001
100000000000001
100000000000001
100000000000001
100000000000001
100000000000001
100000000000001
100000000000001
100000000000001
100000000P00001
100000000000001
111111111111111
