C                    48,            204,255
            EA ./textures/x512/cut_copper_512.xpm     
       SO ./textures/x512/cut_copper_512.xpm
NO ./textures/x512/cut_copper_512.xpm
NO ./textures/x512/cut_copper_512.xpm
F          42,238,    0

WE                      ./textures/x512/cut_copper_512.xpm




1111111111
1000000001
1011100101111
1010000000  1
100000N001111
1000000001
10001100011111111
10011000        01
10000000011111111
111111111110000011
1000000000000011
100000000000001
100000000000001
100000000000001        
100000000000001
100000000000001
111110000000001111
    100000    00001
111110000000001111
111111111111111
100000000000001
100000000000001
100000000000001
10000000000000111
100000000000001
1111111111111111
