NO /home/achak/Documents/graphics_test/xpm_files/brick_wall.xpm 
SO /home/achak/Documents/graphics_test/xpm_files/grey_wall.xpm 
EA /home/achak/Documents/graphics_test/xpm_files/wood.xpm 
WE /home/achak/Documents/graphics_test/xpm_files/4th_brick_wall.xpm 
F                 0  220,100,10                      
C 0,200,200

1111                       1111
1S01                       1001
1001                       1001
1001                       1001
1001                       1001
1001                       1001
1001                       1001
1001                       1001
1001                       1001
1001                       1001
1001                       1001
1001                       1001
1001                       1001
1001                       1001
1001                       1001
1001                       1001
1001                       1001
1001                       1001
1001                       1001
1001                       1001
1001                       1001
1001                       1001
1001                       1001
1001                       1001
1001                       1001
1001                       1001
1001                       1001
1001                       1001
1001                       1001
1001                       1001
1001                       1001
1001                       1001
1001                       1001
1001                       1001
1001                       1001
1001                       1001
1001                       1001
1001                       1001
1001                       1001
1001                       1001
1001                       1001
1001                       1001
1001                       1001
1001                       1001
1001                       1001
1001                       1001
1001                       1001
1001                       1001
1001                       1001
1001                       1001
1001                       1001
1001                       1001
1001                       1001
1001                       1001
1001                       1001
1001                       1001
10011111111111111111111111110011
10000000000000000000000000000001
10000000000000000000000000000001
10000000000000000000000000000001
11111111111111111111111111111111
