NO /home/achak/Documents/new_cub3d/xpm_files/wall-design.xpm
SO /home/achak/Documents/new_cub3d/xpm_files/wall-design.xpm
EA /home/achak/Documents/new_cub3d/xpm_files/wall-design.xpm
WE /home/achak/Documents/new_cub3d/xpm_files/wall-design.xpm
F 255,255,255
C 255,255,255
111111111111111111111111111111
100000000000000000000000000001
110000000000000011110000000001
110000000000000000000000000011
100000000000000000000000000001
111111100000000000000000000101
111111111100000000000000000011
100000000000000000000000000001
100000000000000000000000000001
100000001001001001001001001001
100000001001001001001001001001
100000001001001001001001001001
100000001001001001001001001001
1000000010010010010010010010011111111111111111111111111
1000000010010000000000000000000000000000000000000000S01
1111111111111111111111111111111111111111111111111111111
