
NO /home/achak/Documents/cub3d_folder/new_cub3d/xpm_files/wall-design.xpm
SO /home/achak/Documents/cub3d_folder/new_cub3d/xpm_files/wall-design.xpm
EA /home/achak/Documents/cub3d_folder/new_cub3d/xpm_files/wall-design.xpm
WE /home/achak/Documents/cub3d_folder/new_cub3d/xpm_files/wall-design.xpm
F 255,255,255
C 255,255,255

1111111111111111111
1000000000000000001
1000000000000000001
1000000000000000001
1000000000111000001
1000000000111000001
1000000000111000001
1000000000000000001
10000000S0000000001
1000000000000000001
1111111111111111111
