
NO /home/achak/Documents/graphics_test/xpm_files/brick_wall.xpm 
SO /home/achak/Documents/graphics_test/xpm_files/grey_wall.xpm 
EA /home/achak/Documents/graphics_test/xpm_files/wood.xpm 
WE /home/achak/Documents/graphics_test/xpm_files/4th_brick_wall.xpm 
F 220,100,0
C 0,200,200

1
11
101
1001                           11111111111111111111
10001                          10000000000000000001
100001                         10000000000000000001
1000001                        10000000000000000001
10000001                       10000000000000000001
100000001                      11111111111111111111
1000000001
1N000000001
100000000001
1000000000001
10000000000001
100000000000001
1000000000000001
10000000000000001
100000000000000001
1000000000000000001
10000000000000000001
100000000000000000001
1000000000000000000001
10000000000000000000001
100000000000000000000001
1000000000000000000000001
10000000000000000000000001
100000000000000000000000001
1                          1
1                           1
1                            1
1                             1
1                              1
100000000000000000000000000000001
1000000000000000000000000000000001
10000000000000000000000000000000001
100000000000000000000000000000000001
100000000000000000000000000000000000111
1111111111111111111111111111111111111111
